sL-|||LL
|--L7--|
|--L7--|
LL-|||LL
||||||||
--------
LL-|||LL
L-|L7LLg